//MAP CONVERTED BY dmm2tgm.py THIS HEADER COMMENT PREVENTS RECONVERSION, DO NOT REMOVE
"ac" = (
/obj/structure/fluff/railing/border{
	dir = 10
	},
/turf/open/floor/rogue/greenstone,
/area/rogue/indoors/town/magician/arcynefortress)
"ao" = (
/obj/machinery/light/rogue/firebowl/standing/blue,
/obj/structure/fluff/railing/border{
	dir = 1
	},
/turf/open/floor/rogue/greenstone,
/area/rogue/indoors/town/magician/arcynefortress)
"ar" = (
/obj/structure/table/wood/long_table/right,
/turf/open/floor/rogue/greenstone,
/area/rogue/indoors/town/magician{
	first_time_text = "Arcyne Fortress";
	name = "Arcyne Fortress"
	})
"aJ" = (
/obj/structure/mineral_door/wood/deadbolt/arcyne/caster{
	dir = 4
	},
/turf/open/floor/rogue/greenstone,
/area/rogue/indoors/town/magician/arcynefortress)
"aY" = (
/obj/machinery/light/rogue/candle/blue/l,
/obj/effect/decal/carpet/kover_darkred,
/turf/open/floor/rogue/greenstone,
/area/rogue/indoors/town/magician{
	first_time_text = "Arcyne Fortress";
	name = "Arcyne Fortress"
	})
"aZ" = (
/obj/machinery/light/rogue/candle/blue/r,
/turf/open/floor/rogue/greenstone/runed,
/area/rogue/indoors/town/magician{
	first_time_text = "Arcyne Fortress";
	name = "Arcyne Fortress"
	})
"co" = (
/turf/open/floor/rogue/greenstone/runed,
/area/rogue/indoors/town/magician{
	first_time_text = "Arcyne Fortress";
	name = "Arcyne Fortress"
	})
"cw" = (
/turf/open/transparent/openspace,
/area/rogue)
"cz" = (
/obj/structure/bookcase,
/turf/open/floor/rogue/greenstone/runed,
/area/rogue/indoors/town/magician{
	first_time_text = "Arcyne Fortress";
	name = "Arcyne Fortress"
	})
"dQ" = (
/obj/structure/rack/rogue/shelf,
/obj/structure/bed/rogue/inn/double,
/obj/item/bedsheet/rogue/fabric_double,
/turf/open/floor/rogue/greenstone,
/area/rogue/indoors/town/magician{
	first_time_text = "Arcyne Fortress";
	name = "Arcyne Fortress"
	})
"dU" = (
/turf/template_noop,
/area/template_noop)
"eQ" = (
/obj/structure/chair/bench/couchablack,
/turf/open/floor/rogue/greenstone,
/area/rogue/indoors/town/magician{
	first_time_text = "Arcyne Fortress";
	name = "Arcyne Fortress"
	})
"fH" = (
/obj/structure/mineral_door/wood/deadbolt/arcyne/caster{
	dir = 8
	},
/turf/open/floor/rogue/greenstone,
/area/rogue/indoors/town/magician/arcynefortress)
"gm" = (
/obj/effect/turf_decal/magedecal,
/obj/structure/fluff/railing/border{
	dir = 10
	},
/turf/open/floor/carpet/stellar,
/area/rogue/indoors/town/magician{
	first_time_text = "Arcyne Fortress";
	name = "Arcyne Fortress"
	})
"he" = (
/obj/structure/mineral_door/wood/deadbolt/arcyne/caster,
/turf/open/floor/rogue/greenstone,
/area/rogue/indoors/town/magician/arcynefortress)
"hi" = (
/obj/structure/curtain/directional/blue{
	icon_state = "curtain-closed";
	open = 0
	},
/turf/open/floor/rogue/greenstone/runed,
/area/rogue/indoors/town/magician{
	first_time_text = "Arcyne Fortress";
	name = "Arcyne Fortress"
	})
"hy" = (
/obj/structure/closet/crate/roguecloset,
/turf/open/floor/rogue/greenstone,
/area/rogue/indoors/town/magician{
	first_time_text = "Arcyne Fortress";
	name = "Arcyne Fortress"
	})
"jN" = (
/obj/structure/rack/rogue/shelf/biggest,
/obj/item/reagent_containers/glass/bottle/alchemical{
	pixel_x = 7;
	pixel_y = 8
	},
/obj/item/reagent_containers/glass/bottle/alchemical{
	pixel_x = 7
	},
/obj/item/reagent_containers/glass/bottle/alchemical{
	pixel_x = 7;
	pixel_y = -5
	},
/obj/item/reagent_containers/glass/bottle/alchemical{
	pixel_y = 8
	},
/obj/item/reagent_containers/glass/bottle/alchemical,
/obj/item/reagent_containers/glass/bottle/alchemical{
	pixel_y = -5
	},
/obj/item/reagent_containers/glass/bottle/alchemical{
	pixel_x = -7;
	pixel_y = 8
	},
/obj/item/reagent_containers/glass/bottle/alchemical{
	pixel_x = -7
	},
/obj/item/reagent_containers/glass/bottle/alchemical{
	pixel_x = -7;
	pixel_y = -5
	},
/turf/open/floor/rogue/greenstone,
/area/rogue/indoors/town/magician{
	first_time_text = "Arcyne Fortress";
	name = "Arcyne Fortress"
	})
"lk" = (
/obj/structure/arcyne_wall/greater/caster{
	opacity = 1
	},
/turf/open/floor/rogue/greenstone/runed,
/area/rogue/indoors/town/magician{
	first_time_text = "Arcyne Fortress";
	name = "Arcyne Fortress"
	})
"lP" = (
/obj/structure/fluff/railing/border{
	dir = 10
	},
/obj/structure/fluff/railing/border{
	dir = 9
	},
/turf/open/floor/rogue/greenstone,
/area/rogue/indoors/town/magician{
	first_time_text = "Arcyne Fortress";
	name = "Arcyne Fortress"
	})
"lT" = (
/obj/machinery/light/rogue/cauldron,
/turf/open/floor/rogue/greenstone/runed,
/area/rogue/indoors/town/magician{
	first_time_text = "Arcyne Fortress";
	name = "Arcyne Fortress"
	})
"nJ" = (
/obj/structure/chair/wood/rogue{
	dir = 8
	},
/turf/open/floor/rogue/greenstone/runed,
/area/rogue/indoors/town/magician/arcynefortress)
"nL" = (
/obj/machinery/light/rogue/firebowl/standing/blue,
/turf/open/floor/rogue/greenstone,
/area/rogue/indoors/town/magician{
	first_time_text = "Arcyne Fortress";
	name = "Arcyne Fortress"
	})
"nP" = (
/obj/structure/well/fountain/mana,
/turf/open/floor/rogue/greenstone/runed,
/area/rogue/indoors/town/magician/arcynefortress)
"oK" = (
/obj/structure/fluff/railing/border{
	dir = 5
	},
/turf/open/floor/rogue/greenstone,
/area/rogue/indoors/town/magician/arcynefortress)
"pc" = (
/obj/structure/fluff/railing/border{
	dir = 10
	},
/turf/open/floor/rogue/greenstone,
/area/rogue/indoors/town/magician{
	first_time_text = "Arcyne Fortress";
	name = "Arcyne Fortress"
	})
"qL" = (
/obj/structure/curtain/directional/blue{
	color = "#415e96";
	dir = 1
	},
/turf/open/floor/rogue/greenstone,
/area/rogue/indoors/town/magician{
	first_time_text = "Arcyne Fortress";
	name = "Arcyne Fortress"
	})
"ra" = (
/obj/structure/table/finestone,
/turf/open/floor/rogue/greenstone/runed,
/area/rogue/indoors/town/magician{
	first_time_text = "Arcyne Fortress";
	name = "Arcyne Fortress"
	})
"to" = (
/obj/structure/closet/crate/roguecloset,
/obj/item/reagent_containers/glass/mortar,
/obj/item/reagent_containers/glass/mortar,
/obj/item/pestle{
	pixel_x = -10;
	pixel_y = 1
	},
/obj/item/pestle{
	pixel_x = -10;
	pixel_y = 1
	},
/turf/open/floor/rogue/greenstone,
/area/rogue/indoors/town/magician{
	first_time_text = "Arcyne Fortress";
	name = "Arcyne Fortress"
	})
"vz" = (
/obj/structure/fluff/railing/border{
	dir = 9
	},
/obj/structure/fluff/railing/border{
	dir = 10
	},
/turf/open/floor/rogue/greenstone,
/area/rogue/indoors/town/magician/arcynefortress)
"vA" = (
/obj/structure/table/wood/long_table/mid/alt,
/turf/open/floor/rogue/greenstone/runed,
/area/rogue/indoors/town/magician{
	first_time_text = "Arcyne Fortress";
	name = "Arcyne Fortress"
	})
"wy" = (
/obj/structure/table/wood/poker,
/turf/open/floor/rogue/greenstone,
/area/rogue/indoors/town/magician/arcynefortress)
"wY" = (
/obj/structure/fluff/railing/border{
	dir = 5
	},
/obj/structure/fluff/railing/border{
	dir = 6
	},
/turf/open/floor/rogue/greenstone,
/area/rogue/indoors/town/magician/arcynefortress)
"xd" = (
/obj/structure/chair/wood/rogue{
	dir = 1
	},
/turf/open/floor/rogue/greenstone/runed,
/area/rogue/indoors/town/magician/arcynefortress)
"xY" = (
/obj/structure/stairs{
	dir = 4
	},
/obj/structure/fluff/railing/border{
	dir = 6
	},
/obj/structure/fluff/railing/border{
	dir = 5
	},
/turf/open/floor/rogue/greenstone,
/area/rogue/indoors/town/magician{
	first_time_text = "Arcyne Fortress";
	name = "Arcyne Fortress"
	})
"Ad" = (
/obj/machinery/light/rogue/candle/blue/r,
/turf/open/floor/rogue/greenstone,
/area/rogue/indoors/town/magician/arcynefortress)
"Ak" = (
/obj/structure/fluff/railing/border,
/turf/open/floor/rogue/greenstone,
/area/rogue/indoors/town/magician{
	first_time_text = "Arcyne Fortress";
	name = "Arcyne Fortress"
	})
"AA" = (
/obj/effect/decal/carpet/square/black,
/turf/open/floor/rogue/greenstone,
/area/rogue/indoors/town/magician{
	first_time_text = "Arcyne Fortress";
	name = "Arcyne Fortress"
	})
"BU" = (
/obj/machinery/light/rogue/candle/blue/r,
/turf/open/floor/rogue/greenstone,
/area/rogue/indoors/town/magician{
	first_time_text = "Arcyne Fortress";
	name = "Arcyne Fortress"
	})
"Cj" = (
/obj/machinery/light/rogue/candle/blue/l,
/turf/open/floor/rogue/greenstone,
/area/rogue/indoors/town/magician{
	first_time_text = "Arcyne Fortress";
	name = "Arcyne Fortress"
	})
"Cv" = (
/obj/structure/fluff/railing/border{
	dir = 9
	},
/turf/open/floor/rogue/greenstone,
/area/rogue/indoors/town/magician/arcynefortress)
"CD" = (
/obj/structure/fluff/railing/border{
	dir = 6
	},
/turf/open/floor/rogue/greenstone,
/area/rogue/indoors/town/magician{
	first_time_text = "Arcyne Fortress";
	name = "Arcyne Fortress"
	})
"Di" = (
/obj/effect/decal/carpet/kover_purple,
/turf/open/floor/rogue/greenstone,
/area/rogue/indoors/town/magician{
	first_time_text = "Arcyne Fortress";
	name = "Arcyne Fortress"
	})
"Dj" = (
/obj/structure/chair/wood/rogue{
	dir = 4;
	pixel_x = 5
	},
/turf/open/floor/rogue/greenstone/runed,
/area/rogue/indoors/town/magician/arcynefortress)
"DD" = (
/obj/structure/bookcase,
/turf/open/floor/rogue/greenstone,
/area/rogue/indoors/town/magician{
	first_time_text = "Arcyne Fortress";
	name = "Arcyne Fortress"
	})
"DH" = (
/obj/structure/fluff/railing/border{
	dir = 6
	},
/turf/open/floor/carpet/stellar,
/area/rogue/indoors/town/magician{
	first_time_text = "Arcyne Fortress";
	name = "Arcyne Fortress"
	})
"In" = (
/obj/machinery/light/rogue/firebowl/standing/blue,
/turf/open/floor/rogue/greenstone,
/area/rogue/indoors/town/magician/arcynefortress)
"Io" = (
/obj/machinery/light/rogue/candle/blue/l,
/turf/open/floor/rogue/greenstone,
/area/rogue/indoors/town/magician/arcynefortress)
"JU" = (
/obj/structure/stairs{
	dir = 8
	},
/obj/structure/fluff/railing/border{
	dir = 5
	},
/obj/structure/fluff/railing/border{
	dir = 6
	},
/turf/open/floor/rogue/greenstone,
/area/rogue/indoors/town/magician/arcynefortress)
"Lt" = (
/obj/structure/fluff/railing/border{
	dir = 5
	},
/turf/open/floor/rogue/greenstone,
/area/rogue/indoors/town/magician{
	first_time_text = "Arcyne Fortress";
	name = "Arcyne Fortress"
	})
"LM" = (
/obj/structure/fluff/railing/border{
	dir = 6
	},
/obj/structure/fluff/railing/border{
	dir = 5
	},
/turf/open/floor/rogue/greenstone,
/area/rogue/indoors/town/magician{
	first_time_text = "Arcyne Fortress";
	name = "Arcyne Fortress"
	})
"Mp" = (
/obj/effect/decal/carpet/square,
/turf/open/floor/rogue/greenstone/runed,
/area/rogue/indoors/town/magician{
	first_time_text = "Arcyne Fortress";
	name = "Arcyne Fortress"
	})
"Mw" = (
/obj/structure/bed/rogue/inn/double{
	dir = 1
	},
/obj/item/bedsheet/rogue/fabric_double{
	dir = 1
	},
/turf/open/floor/rogue/greenstone,
/area/rogue/indoors/town/magician{
	first_time_text = "Arcyne Fortress";
	name = "Arcyne Fortress"
	})
"MG" = (
/obj/structure/fluff/railing/border{
	dir = 9
	},
/turf/open/floor/rogue/greenstone,
/area/rogue/indoors/town/magician{
	first_time_text = "Arcyne Fortress";
	name = "Arcyne Fortress"
	})
"MO" = (
/obj/structure/arcyne_wall/greater/caster,
/turf/open/floor/rogue/greenstone,
/area/rogue/indoors/town/magician/arcynefortress)
"Ok" = (
/obj/structure/table/wood/poor,
/turf/open/floor/rogue/greenstone/runed,
/area/rogue/indoors/town/magician{
	first_time_text = "Arcyne Fortress";
	name = "Arcyne Fortress"
	})
"Pe" = (
/turf/open/floor/rogue/greenstone,
/area/rogue/indoors/town/magician{
	first_time_text = "Arcyne Fortress";
	name = "Arcyne Fortress"
	})
"Qg" = (
/obj/structure/chair/bench/couchablack/r,
/turf/open/floor/rogue/greenstone/runed,
/area/rogue/indoors/town/magician{
	first_time_text = "Arcyne Fortress";
	name = "Arcyne Fortress"
	})
"QN" = (
/turf/open/floor/rogue/greenstone/runed,
/area/rogue/indoors/town/magician/arcynefortress)
"RX" = (
/obj/structure/stairs{
	dir = 8
	},
/obj/structure/fluff/railing/border{
	dir = 10
	},
/obj/structure/fluff/railing/border{
	dir = 9
	},
/turf/open/floor/rogue/greenstone,
/area/rogue/indoors/town/magician{
	first_time_text = "Arcyne Fortress";
	name = "Arcyne Fortress"
	})
"SK" = (
/obj/structure/arcyne_wall/greater/caster{
	opacity = 1
	},
/turf/open/floor/rogue/greenstone,
/area/rogue/indoors/town/magician{
	first_time_text = "Arcyne Fortress";
	name = "Arcyne Fortress"
	})
"TI" = (
/obj/structure/fluff/railing/border{
	dir = 1
	},
/turf/open/floor/rogue/greenstone,
/area/rogue/indoors/town/magician{
	first_time_text = "Arcyne Fortress";
	name = "Arcyne Fortress"
	})
"Uk" = (
/obj/structure/stairs{
	dir = 4
	},
/obj/structure/fluff/railing/border{
	dir = 10
	},
/obj/structure/fluff/railing/border{
	dir = 9
	},
/turf/open/floor/rogue/ruinedwood,
/area/rogue/indoors/town/magician/arcynefortress)
"Um" = (
/obj/structure/fluff/alch,
/turf/open/floor/rogue/greenstone,
/area/rogue/indoors/town/magician{
	first_time_text = "Arcyne Fortress";
	name = "Arcyne Fortress"
	})
"Vr" = (
/obj/structure/table/wood/long_table,
/turf/open/floor/rogue/greenstone,
/area/rogue/indoors/town/magician{
	first_time_text = "Arcyne Fortress";
	name = "Arcyne Fortress"
	})
"VR" = (
/obj/machinery/light/rogue/candle/blue/r,
/turf/open/floor/rogue/greenstone/runed,
/area/rogue/indoors/town/magician/arcynefortress)
"VZ" = (
/turf/open/floor/rogue/greenstone,
/area/rogue/indoors/town/magician/arcynefortress)
"Wz" = (
/obj/structure/fluff/railing/border{
	dir = 6
	},
/turf/open/floor/rogue/greenstone/runed,
/area/rogue/indoors/town/magician/arcynefortress)
"WN" = (
/obj/structure/rack/rogue/shelf/biggest,
/turf/open/floor/rogue/greenstone,
/area/rogue/indoors/town/magician{
	first_time_text = "Arcyne Fortress";
	name = "Arcyne Fortress"
	})
"Xh" = (
/obj/structure/fluff/railing/border{
	dir = 6
	},
/turf/open/floor/rogue/greenstone,
/area/rogue/indoors/town/magician/arcynefortress)
"XH" = (
/turf/open/transparent/openspace,
/area/rogue/indoors/town/magician{
	first_time_text = "Arcyne Fortress";
	name = "Arcyne Fortress"
	})
"XT" = (
/turf/open/floor/carpet/stellar,
/area/rogue/indoors/town/magician{
	first_time_text = "Arcyne Fortress";
	name = "Arcyne Fortress"
	})
"Yf" = (
/obj/structure/fluff/railing/border,
/turf/open/floor/rogue/greenstone,
/area/rogue/indoors/town/magician/arcynefortress)
"ZS" = (
/obj/machinery/light/rogue/firebowl/standing/blue,
/turf/open/floor/rogue/greenstone/runed,
/area/rogue/indoors/town/magician{
	first_time_text = "Arcyne Fortress";
	name = "Arcyne Fortress"
	})
"ZX" = (
/obj/structure/fluff/railing/border{
	dir = 10
	},
/turf/open/floor/rogue/greenstone/runed,
/area/rogue/indoors/town/magician/arcynefortress)

(1,1,1) = {"
dU
MO
MO
MO
MO
MO
he
MO
MO
MO
MO
MO
dU
"}
(2,1,1) = {"
MO
MO
VZ
Io
QN
VZ
VZ
VZ
QN
Io
VZ
MO
MO
"}
(3,1,1) = {"
MO
VZ
QN
MO
MO
MO
aJ
MO
MO
MO
QN
VZ
MO
"}
(4,1,1) = {"
MO
VZ
MO
MO
wy
xd
VZ
Xh
MO
MO
MO
QN
MO
"}
(5,1,1) = {"
MO
QN
MO
In
nJ
VZ
VZ
Yf
JU
ao
MO
VZ
MO
"}
(6,1,1) = {"
MO
VZ
MO
QN
VZ
VZ
VZ
ZX
vz
Cv
MO
VZ
MO
"}
(7,1,1) = {"
MO
VZ
MO
nP
QN
QN
QN
QN
QN
QN
MO
QN
MO
"}
(8,1,1) = {"
MO
QN
MO
QN
VZ
VZ
VZ
Wz
wY
oK
MO
VZ
MO
"}
(9,1,1) = {"
MO
VZ
MO
In
Dj
VZ
VZ
Yf
Uk
ao
MO
QN
MO
"}
(10,1,1) = {"
MO
VZ
MO
MO
wy
xd
VZ
ac
MO
MO
MO
VZ
MO
"}
(11,1,1) = {"
MO
VZ
QN
MO
MO
MO
fH
MO
MO
MO
QN
VZ
MO
"}
(12,1,1) = {"
MO
MO
VZ
Ad
VZ
QN
VZ
VZ
VZ
VR
VZ
MO
MO
"}
(13,1,1) = {"
dU
MO
MO
MO
MO
MO
fH
MO
MO
MO
MO
MO
dU
"}

(1,1,2) = {"
cw
SK
SK
SK
SK
SK
SK
SK
SK
SK
SK
SK
cw
"}
(2,1,2) = {"
SK
SK
Mw
aY
lk
DD
DD
Pe
co
Cj
Pe
SK
SK
"}
(3,1,2) = {"
SK
WN
co
Pe
qL
Pe
Pe
CD
LM
Lt
Mp
DD
SK
"}
(4,1,2) = {"
SK
hy
Pe
Pe
SK
ra
Pe
Ak
RX
TI
Pe
cz
SK
"}
(5,1,2) = {"
SK
lk
SK
SK
lk
to
Pe
Ak
XH
TI
Pe
nL
SK
"}
(6,1,2) = {"
SK
Um
Pe
co
Cj
XT
XT
gm
SK
MG
Pe
Vr
SK
"}
(7,1,2) = {"
SK
lT
Pe
Ok
co
XT
XT
XT
hi
co
Pe
vA
SK
"}
(8,1,2) = {"
SK
jN
Pe
co
BU
XT
XT
DH
SK
Lt
Pe
ar
SK
"}
(9,1,2) = {"
SK
SK
SK
SK
lk
eQ
Pe
Ak
XH
TI
Pe
ZS
SK
"}
(10,1,2) = {"
SK
hy
Pe
Pe
SK
Qg
Pe
Ak
xY
TI
AA
DD
SK
"}
(11,1,2) = {"
SK
WN
co
Di
qL
Pe
Pe
pc
lP
MG
co
DD
SK
"}
(12,1,2) = {"
SK
SK
dQ
BU
SK
cz
DD
Pe
Pe
aZ
Pe
SK
SK
"}
(13,1,2) = {"
cw
SK
SK
SK
SK
SK
SK
SK
SK
SK
SK
SK
cw
"}

(1,1,3) = {"
cw
Pe
Pe
Pe
Pe
Pe
Pe
Pe
Pe
Pe
Pe
Pe
cw
"}
(2,1,3) = {"
Pe
Pe
Pe
Pe
co
Pe
Pe
Pe
co
Pe
Pe
Pe
Pe
"}
(3,1,3) = {"
Pe
Pe
co
Pe
Pe
Pe
Pe
Pe
Pe
Pe
co
Pe
Pe
"}
(4,1,3) = {"
Pe
Pe
Pe
Pe
Pe
co
Pe
Pe
Pe
Pe
Pe
co
Pe
"}
(5,1,3) = {"
Pe
co
Pe
Pe
co
Pe
Pe
Pe
Pe
Pe
Pe
Pe
Pe
"}
(6,1,3) = {"
Pe
Pe
Pe
co
Pe
Pe
Pe
co
Pe
Pe
Pe
Pe
Pe
"}
(7,1,3) = {"
Pe
Pe
Pe
co
co
co
co
co
co
co
Pe
co
Pe
"}
(8,1,3) = {"
Pe
co
Pe
co
Pe
Pe
Pe
co
Pe
Pe
Pe
Pe
Pe
"}
(9,1,3) = {"
Pe
Pe
Pe
Pe
co
Pe
Pe
Pe
Pe
Pe
Pe
co
Pe
"}
(10,1,3) = {"
Pe
Pe
Pe
Pe
Pe
co
Pe
Pe
Pe
Pe
Pe
Pe
Pe
"}
(11,1,3) = {"
Pe
Pe
co
Pe
Pe
Pe
Pe
Pe
Pe
Pe
co
Pe
Pe
"}
(12,1,3) = {"
Pe
Pe
Pe
Pe
Pe
co
Pe
Pe
Pe
co
Pe
Pe
Pe
"}
(13,1,3) = {"
cw
Pe
Pe
Pe
Pe
Pe
Pe
Pe
Pe
Pe
Pe
Pe
cw
"}
